000000000000000
000000000000000
000000000000000
000000000000000
000000000000000
000000000000000
000000000000000
000000000000000
000000000111000
000001001000000
000001001000000
000001001000000
000000110111000
000001000100000
000001000100000
000001000100000
000000000000000
000000000000000
000000000000000
000000000000000
