000000000000000
000000000000000
000000000000000
000100100100000
000000000000000
000000000001000
000000000000000
000000010000000
000000000000000
001000100000000
010000000000000
010000000001011
100000100000000
000000000000000
000000100000000
000000000010000
000100100010000
000000000010000
000000000010000
000000000010000
