000000000000000
000000000000000
000000000000000
000000000000000
000111111111000
000100000001000
000100000001000
000100000001000
000100000001000
000100000001000
000100000001000
000100000000000
000100000000000
000100000000000
000100000000000
000000000000000
000000000000000
000000000000000
000000000000000
000000000000000
