000100000000000
000100000000000
000100000000000
000100000000000
000100010000000
000100000001000
000000000000000
000000010000000
000000000000100
001000000000000
010000000000000
010000000000011
100000100000000
000000000000000
000000000000000
000000000010000
000100000010000
000001000010000
000001000010000
000001000010000
