000000000000000
000000000000000
000000000000000
000100000000000
000000000000000
000000000011100
000000000000000
011100000000000
000000000000000
000100000000000
001000000000000
010000000011011
100000100000000
000000000000000
000000000000000
000000000000000
111100000010000
000100000100000
000100000100000
000100000100000
