000000000000000
000000000000000
000000000000000
000000000000000
000000000100000
000100000000010
000000000000000
000001000000000
000000010000000
000000000000100
000000000000000
000000000000000
000000001100000
000000010000000
001000100000000
001000000000000
001000000000000
001000000000000
001000000000000
000000000000000
