000000000000000
000000000000000
000000000000000
000000101000000
000000000000000
000000000000000
000000000000000
000010000000000
000010001010000
000100000000000
001000100000000
010000000000000
100000010001111
000000000000000
000000000000000
000000000000000
000000000010000
000100000100000
000100000100000
000100000100000
