000000000000000
000000000000000
000000000100000
000000000010000
000100000001000
000010000000000
000001000000000
000000000000000
000000000000000
000000000000000
001000000100000
000100000010000
000010000001000
000000000000000
000000000000000
000000000000000
000000000000000
000000000100000
000000000010000
000000000001000
