000000000000000
000000000000000
000000000000000
000001000000000
000001111111000
000010000001000
000010000001000
000010000001000
000010000001000
000010000001000
000010000001000
000010000001000
000010000001000
000000000001000
000000000000000
000000000000000
000000010000000
000000000000000
000000000000000
000000000000000
