000000000000000
000000100000000
000000001000000
000000000010000
000000000000000
000000000000000
000001111100000
000010000000000
000010000000000
000010000001000
000010000000000
000010000000000
000010000000000
000001111110000
000000000000000
000000000000000
110000000000000
000000000000000
000000000000000
000000000100000
