000000000100000
000000001000000
000000000000000
000000000000000
110000000000000
000101010101000
000000000000000
000100000000000
000000000000000
000100000000000
000100000000111
000000000000000
000100000000000
000000000000000
000110100101000
000000000000000
000000000000000
000000000000000
000100010000000
000100010000000
